11111
1P111
1C111
1E111
11111
